######
#    #
#$$..#
#@   #
#    #
#    #
#    #
######