###########
#.       .#
#         #
#   $$$  .#
#         #
#@        #
###########


      #####
      #.  #
      #.# #
#######.# #
# $@  $ $ #
# # # # ###
#       #
#########

###############
###  #.  #   ##
###$    @  $ ##
###.        ###
####       ####
#####  . $ ####
###############