######
# .. #
# $$ #
# @  #
######