###########
#.       .#
#         #
#   $$$  .#
#         #
#@        #
###########