###############
##.. # # ..# @#
##$$..#..$$# ##
##  $$ $$  #  #
###       ### #
#             #
#  # # # #   ##
#  #     #    #
#           # #
###############