###############
###  #.  #   ##
###$    @  $ ##
###.        ###
####       ####
#####  . $ ####
###############